1
8,7
0,2,1,1,2,2,0,0
0,2,5,2,1,1,2,0
2,2,2,1,2,1,1,0
3,1,1,1,1,1,2,1
2,1,2,2,1,2,1,0
0,2,1,1,2,2,1,0
0,2,2,5,2,4,0,0
0,3
5,6
2
2,1
3,6