6
8,7
0,2,1,1,2,2,0,0
0,2,5,2,1,1,2,0
2,2,2,1,2,1,1,0
3,1,1,1,1,1,2,1
2,1,2,2,1,2,1,0
0,2,1,1,2,2,1,0
0,2,2,5,2,4,0,0
0,3
5,6
2
2,1
3,6
0
6,7
0,2,2,2,0,0
0,2,1,1,5,0
1,4,2,2,2,0
5,2,1,1,1,3
2,1,2,1,2,0
0,2,1,1,2,0
0,2,2,2,0,0
5,3
1,2
2
0,3
4,1
0
6,8
0,0,0,2,2,0
0,0,0,2,4,2
0,1,1,1,1,5
0,1,2,1,2,2
1,2,1,2,0,0
0,1,1,1,2,2
3,2,2,1,1,5
0,1,1,1,0,0
0,6
4,1
2
5,2
5,6
0
8,9
0,6,2,2,0,0,0,0
0,3,1,1,2,0,0,0
2,1,2,1,5,0,0,0
2,1,2,1,2,0,2,4
2,1,1,2,0,2,1,2
0,2,2,2,0,6,1,2
0,0,0,0,2,1,2,0
0,0,0,0,0,2,1,2
0,0,0,0,0,2,5,0
1,1
7,3
2
4,2
6,8
0
10,8
0,0,5,2,0,0,8,2,2,0
3,2,2,1,2,0,2,1,1,2
1,1,1,2,0,7,2,2,1,2
1,2,2,1,2,0,5,1,1,4
1,6,1,2,0,0,0,0,0,0
0,2,2,5,0,0,2,2,2,7
0,0,0,0,0,6,1,1,1,1
0,0,0,0,0,0,2,2,2,2
0,1
5,5
3
2,0
3,5
6,3
0
6,3
2,2,2,2,2,0
3,1,4,1,5,2
2,2,2,2,2,0
0,1
2,1
1
4,1
1
1,1
